po/sr/security/manager/chrome/pipnss/nsserrors.properties.po:	264 vertaalde berichten.
po/sr/security/manager/chrome/pipnss/security.properties.po:	15 vertaalde berichten.
po/sr/security/manager/chrome/pipnss/pipnss.properties.po:	330 vertaalde berichten.
po/sr/security/manager/chrome/pippki/deviceManager.dtd.po:	22 vertaalde berichten.
po/sr/security/manager/chrome/pippki/certManager.dtd.po:	78 vertaalde berichten.
po/sr/security/manager/chrome/pippki/validation.dtd.po:	26 vertaalde berichten.
po/sr/security/manager/chrome/pippki/pippki.properties.po:	141 vertaalde berichten.
po/sr/security/manager/chrome/pippki/pippki.dtd.po:	68 vertaalde berichten.
po/sr/mail/updater/updater.ini.po:	2 vertaalde berichten.
po/sr/mail/chrome/branding/brand.dtd.po:	3 vertaalde berichten.
po/sr/mail/chrome/branding/brand.properties.po:	3 vertaalde berichten.
po/sr/mail/chrome/messenger-mapi/mapi.properties.po:	17 vertaalde berichten.
po/sr/mail/chrome/mozldap/ldap.properties.po:	62 vertaalde berichten.
po/sr/mail/chrome/global-platform/win/nsWindowsHooks.properties.po:	6 vertaalde berichten.
po/sr/mail/chrome/messenger-smime/msgReadSMIMEOverlay.dtd.po:	1 vertaald bericht.
po/sr/mail/chrome/messenger-smime/msgReadSMIMEOverlay.properties.po:	3 vertaalde berichten.
po/sr/mail/chrome/messenger-smime/certFetchingStatus.dtd.po:	3 vertaalde berichten.
po/sr/mail/chrome/messenger-smime/msgReadSecurityInfo.dtd.po:	7 vertaalde berichten.
po/sr/mail/chrome/messenger-smime/msgCompSecurityInfo.properties.po:	9 vertaalde berichten.
po/sr/mail/chrome/messenger-smime/msgCompSMIMEOverlay.dtd.po:	9 vertaalde berichten.
po/sr/mail/chrome/messenger-smime/msgCompSecurityInfo.dtd.po:	11 vertaalde berichten.
po/sr/mail/chrome/messenger-smime/msgSecurityInfo.properties.po:	50 vertaalde berichten.
po/sr/mail/chrome/messenger-smime/msgCompSMIMEOverlay.properties.po:	1 vertaald bericht.
po/sr/mail/chrome/communicator/contentAreaCommands.properties.po:	13 vertaalde berichten.
po/sr/mail/chrome/communicator/wallet/SignonViewer.properties.po:	8 vertaalde berichten.
po/sr/mail/chrome/communicator/wallet/wallet.properties.po:	41 vertaalde berichten.
po/sr/mail/chrome/communicator/wallet/SignonViewer.dtd.po:	15 vertaalde berichten.
po/sr/mail/chrome/communicator/utilityOverlay.properties.po:	5 vertaalde berichten.
po/sr/mail/chrome/communicator/utilityOverlay.dtd.po:	36 vertaalde berichten.
po/sr/mail/chrome/global/charset.dtd.po:	10 vertaalde berichten.
po/sr/mail/chrome/messenger/importMsgs.properties.po:	87 vertaalde berichten.
po/sr/mail/chrome/messenger/markByDate.dtd.po:	3 vertaalde berichten.
po/sr/mail/chrome/messenger/comm4xMailImportMsgs.properties.po:	5 vertaalde berichten.
po/sr/mail/chrome/messenger/msgViewPickerOverlay.dtd.po:	7 vertaalde berichten.
po/sr/mail/chrome/messenger/messengercompose/askSendFormat.properties.po:	4 vertaalde berichten.
po/sr/mail/chrome/messenger/messengercompose/sendProgress.properties.po:	5 vertaalde berichten.
po/sr/mail/chrome/messenger/messengercompose/addressingWidgetOverlay.dtd.po:	6 vertaalde berichten.
po/sr/mail/chrome/messenger/messengercompose/askSendFormat.dtd.po:	7 vertaalde berichten.
po/sr/mail/chrome/messenger/messengercompose/messengercompose.dtd.po:	153 vertaalde berichten.
po/sr/mail/chrome/messenger/messengercompose/composeMsgs.properties.po:	108 vertaalde berichten.
po/sr/mail/chrome/messenger/messengercompose/mailComposeEditorOverlay.dtd.po:	2 vertaalde berichten.
po/sr/mail/chrome/messenger/messengercompose/sendProgress.dtd.po:	3 vertaalde berichten.
po/sr/mail/chrome/messenger/subscribe.dtd.po:	8 vertaalde berichten.
po/sr/mail/chrome/messenger/folderpane.dtd.po:	5 vertaalde berichten.
po/sr/mail/chrome/messenger/am-copies.dtd.po:	17 vertaalde berichten.
po/sr/mail/chrome/messenger/searchTermOverlay.dtd.po:	5 vertaalde berichten.
po/sr/mail/chrome/messenger/search.properties.po:	10 vertaalde berichten.
po/sr/mail/chrome/messenger/aboutDialog.dtd.po:	5 vertaalde berichten.
po/sr/mail/chrome/messenger/am-addressing.dtd.po:	16 vertaalde berichten.
po/sr/mail/chrome/messenger/filter.properties.po:	38 vertaalde berichten.
po/sr/mail/chrome/messenger/mailviews.properties.po:	5 vertaalde berichten.
po/sr/mail/chrome/messenger/AccountManager.dtd.po:	9 vertaalde berichten.
po/sr/mail/chrome/messenger/downloadheaders.dtd.po:	4 vertaalde berichten.
po/sr/mail/chrome/messenger/fieldMapExport.dtd.po:	4 vertaalde berichten.
po/sr/mail/chrome/messenger/am-server-top.dtd.po:	51 vertaalde berichten.
po/sr/mail/chrome/messenger/SearchDialog.dtd.po:	58 vertaalde berichten.
po/sr/mail/chrome/messenger/msgHdrViewOverlay.dtd.po:	29 vertaalde berichten.
po/sr/mail/chrome/messenger/migration/migration.dtd.po:	18 vertaalde berichten.
po/sr/mail/chrome/messenger/migration/migration.properties.po:	16 vertaalde berichten.
po/sr/mail/chrome/messenger/virtualFolderName.dtd.po:	2 vertaalde berichten.
po/sr/mail/chrome/messenger/folderProps.dtd.po:	34 vertaalde berichten.
po/sr/mail/chrome/messenger/mailViewSetup.dtd.po:	3 vertaalde berichten.
po/sr/mail/chrome/messenger/prefs.properties.po:	38 vertaalde berichten.
po/sr/mail/chrome/messenger/vcard.properties.po:	62 vertaalde berichten.
po/sr/mail/chrome/messenger/smime.properties.po:	1 vertaald bericht.
po/sr/mail/chrome/messenger/am-smime.dtd.po:	16 vertaalde berichten.
po/sr/mail/chrome/messenger/search-operators.properties.po:	18 vertaalde berichten.
po/sr/mail/chrome/messenger/virtualFolderListDialog.dtd.po:	2 vertaalde berichten.
po/sr/mail/chrome/messenger/mailEditorOverlay.dtd.po:	1 vertaald bericht.
po/sr/mail/chrome/messenger/tabmail.dtd.po:	7 vertaalde berichten.
po/sr/mail/chrome/messenger/imapMsgs.properties.po:	85 vertaalde berichten, 1 onvertaald bericht.
po/sr/mail/chrome/messenger/localMsgs.properties.po:	41 vertaalde berichten.
po/sr/mail/chrome/messenger/am-offline.dtd.po:	23 vertaalde berichten.
po/sr/mail/chrome/messenger/subscribe.properties.po:	6 vertaalde berichten.
po/sr/mail/chrome/messenger/credits.dtd.po:	23 vertaalde berichten.
po/sr/mail/chrome/messenger/am-server-advanced.dtd.po:	18 vertaalde berichten.
po/sr/mail/chrome/messenger/smtpEditOverlay.dtd.po:	15 vertaalde berichten.
po/sr/mail/chrome/messenger/msgFolderPickerOverlay.dtd.po:	9 vertaalde berichten.
po/sr/mail/chrome/messenger/msgSynchronize.dtd.po:	12 vertaalde berichten.
po/sr/mail/chrome/messenger/mimeheader.properties.po:	25 vertaalde berichten.
po/sr/mail/chrome/messenger/outlookImportMsgs.properties.po:	9 vertaalde berichten.
po/sr/mail/chrome/messenger/offline.properties.po:	11 vertaalde berichten.
po/sr/mail/chrome/messenger/mailTurboMenu.properties.po:	2 vertaalde berichten.
po/sr/mail/chrome/messenger/mime.properties.po:	46 vertaalde berichten.
po/sr/mail/chrome/messenger/am-junk.dtd.po:	10 vertaalde berichten.
po/sr/mail/chrome/messenger/eudoraImportMsgs.properties.po:	26 vertaalde berichten.
po/sr/mail/chrome/messenger/offlineStartup.properties.po:	3 vertaalde berichten.
po/sr/mail/chrome/messenger/viewLog.dtd.po:	5 vertaalde berichten.
po/sr/mail/chrome/messenger/FilterEditor.dtd.po:	27 vertaalde berichten.
po/sr/mail/chrome/messenger/newTagDialog.dtd.po:	2 vertaalde berichten.
po/sr/mail/chrome/messenger/oeImportMsgs.properties.po:	10 vertaalde berichten.
po/sr/mail/chrome/messenger/preferences/junkLog.dtd.po:	4 vertaalde berichten.
po/sr/mail/chrome/messenger/preferences/preferences.dtd.po:	12 vertaalde berichten.
po/sr/mail/chrome/messenger/preferences/preferences.properties.po:	43 vertaalde berichten.
po/sr/mail/chrome/messenger/preferences/changeaction.dtd.po:	12 vertaalde berichten.
po/sr/mail/chrome/messenger/preferences/downloadactions.dtd.po:	16 vertaalde berichten.
po/sr/mail/chrome/messenger/preferences/general.dtd.po:	21 vertaalde berichten.
po/sr/mail/chrome/messenger/preferences/advanced.dtd.po:	47 vertaalde berichten.
po/sr/mail/chrome/messenger/preferences/downloads.dtd.po:	14 vertaalde berichten.
po/sr/mail/chrome/messenger/preferences/viewpasswords.dtd.po:	10 vertaalde berichten.
po/sr/mail/chrome/messenger/preferences/sendoptions.dtd.po:	24 vertaalde berichten.
po/sr/mail/chrome/messenger/preferences/compose.dtd.po:	38 vertaalde berichten.
po/sr/mail/chrome/messenger/preferences/offline.dtd.po:	13 vertaalde berichten.
po/sr/mail/chrome/messenger/preferences/connection.dtd.po:	21 vertaalde berichten.
po/sr/mail/chrome/messenger/preferences/notifications.dtd.po:	6 vertaalde berichten.
po/sr/mail/chrome/messenger/preferences/fonts.dtd.po:	53 vertaalde berichten.
po/sr/mail/chrome/messenger/preferences/display.dtd.po:	32 vertaalde berichten.
po/sr/mail/chrome/messenger/preferences/privacy.dtd.po:	27 vertaalde berichten.
po/sr/mail/chrome/messenger/preferences/receipts.dtd.po:	14 vertaalde berichten.
po/sr/mail/chrome/messenger/am-serverwithnoidentities.dtd.po:	8 vertaalde berichten.
po/sr/mail/chrome/messenger/defaultClientDialog.dtd.po:	6 vertaalde berichten.
po/sr/mail/chrome/messenger/msgmdn.properties.po:	14 vertaalde berichten.
po/sr/mail/chrome/messenger/importDialog.dtd.po:	25 vertaalde berichten.
po/sr/mail/chrome/messenger/am-dsn.properties.po:	1 vertaald bericht.
po/sr/mail/chrome/messenger/news.properties.po:	26 vertaalde berichten.
po/sr/mail/chrome/messenger/AccountWizard.dtd.po:	56 vertaalde berichten.
po/sr/mail/chrome/messenger/am-mdn.dtd.po:	16 vertaalde berichten.
po/sr/mail/chrome/messenger/messenger.dtd.po:	356 vertaalde berichten.
po/sr/mail/chrome/messenger/start.dtd.po:	23 vertaalde berichten, 1 onvertaald bericht.
po/sr/mail/chrome/messenger/am-identity-edit.dtd.po:	5 vertaalde berichten.
po/sr/mail/chrome/messenger/fieldMapImport.dtd.po:	11 vertaalde berichten.
po/sr/mail/chrome/messenger/am-advanced.dtd.po:	12 vertaalde berichten.
po/sr/mail/chrome/messenger/custom.properties.po:	2 vertaalde berichten.
po/sr/mail/chrome/messenger/newFolderDialog.dtd.po:	7 vertaalde berichten.
po/sr/mail/chrome/messenger/virtualFolderProperties.dtd.po:	7 vertaalde berichten.
po/sr/mail/chrome/messenger/search-attributes.properties.po:	38 vertaalde berichten.
po/sr/mail/chrome/messenger/am-main.dtd.po:	17 vertaalde berichten.
po/sr/mail/chrome/messenger/am-dsn.dtd.po:	9 vertaalde berichten.
po/sr/mail/chrome/messenger/addressbook/abNewCardDialog.dtd.po:	1 vertaald bericht.
po/sr/mail/chrome/messenger/addressbook/abMailListDialog.dtd.po:	9 vertaalde berichten.
po/sr/mail/chrome/messenger/addressbook/abDirTreeOverlay.dtd.po:	1 vertaald bericht.
po/sr/mail/chrome/messenger/addressbook/pref-directory-add.dtd.po:	21 vertaalde berichten.
po/sr/mail/chrome/messenger/addressbook/abResultsPaneOverlay.dtd.po:	21 vertaalde berichten.
po/sr/mail/chrome/messenger/addressbook/abSelectAddressesDialog.dtd.po:	15 vertaalde berichten.
po/sr/mail/chrome/messenger/addressbook/abAddressBookNameDialog.dtd.po:	1 vertaald bericht.
po/sr/mail/chrome/messenger/addressbook/abCardViewOverlay.dtd.po:	9 vertaalde berichten.
po/sr/mail/chrome/messenger/addressbook/replicationProgress.properties.po:	10 vertaalde berichten.
po/sr/mail/chrome/messenger/addressbook/addressBook.properties.po:	87 vertaalde berichten, 1 onvertaald bericht.
po/sr/mail/chrome/messenger/addressbook/abCardOverlay.dtd.po:	50 vertaalde berichten, 4 onvertaalde berichten.
po/sr/mail/chrome/messenger/addressbook/ldapAutoCompErrs.properties.po:	16 vertaalde berichten.
po/sr/mail/chrome/messenger/addressbook/pref-directory.dtd.po:	8 vertaalde berichten.
po/sr/mail/chrome/messenger/addressbook/abMainWindow.dtd.po:	117 vertaalde berichten, 1 onvertaald bericht.
po/sr/mail/chrome/messenger/addressbook/abContactsPanel.dtd.po:	9 vertaalde berichten.
po/sr/mail/chrome/messenger/textImportMsgs.properties.po:	7 vertaalde berichten.
po/sr/mail/chrome/messenger/mailViewList.dtd.po:	2 vertaalde berichten.
po/sr/mail/chrome/messenger/messenger.properties.po:	193 vertaalde berichten, 2 onvertaalde berichten.
po/sr/mail/chrome/messenger/am-mdn.properties.po:	1 vertaald bericht.
po/sr/mail/chrome/messenger/mailOverlay.dtd.po:	4 vertaalde berichten.
po/sr/mail/chrome/messenger/CustomHeaders.dtd.po:	4 vertaalde berichten.
po/sr/mail/chrome/messenger/shutdownWindow.properties.po:	2 vertaalde berichten.
po/sr/mail/chrome/messenger/msgAccountCentral.dtd.po:	16 vertaalde berichten.
po/sr/mail/chrome/messenger/am-smime.properties.po:	15 vertaalde berichten.
po/sr/mail/chrome/messenger/junkMailInfo.dtd.po:	7 vertaalde berichten.
po/sr/mail/chrome/messenger/am-identities-list.dtd.po:	5 vertaalde berichten.
po/sr/mail/chrome/messenger/renameFolderDialog.dtd.po:	2 vertaalde berichten.
po/sr/mail/chrome/messenger/FilterListDialog.dtd.po:	18 vertaalde berichten.
po/sr/mail/chrome/messenger/shellservice.properties.po:	4 vertaalde berichten.
po/sr/mail/chrome/messenger-newsblog/feed-subscriptions.dtd.po:	10 vertaalde berichten.
po/sr/mail/chrome/messenger-newsblog/am-newsblog.dtd.po:	9 vertaalde berichten.
po/sr/mail/chrome/messenger-newsblog/feed-properties.dtd.po:	7 vertaalde berichten.
po/sr/mail/chrome/messenger-newsblog/newsblog.dtd.po:	1 vertaald bericht.
po/sr/mail/chrome/messenger-newsblog/newsblog.properties.po:	19 vertaalde berichten.
po/sr/mail/chrome/messenger-newsblog/am-newsblog.properties.po:	1 vertaald bericht.
po/sr/mail/chrome/messenger-region/region.properties.po:	3 vertaalde berichten.
po/sr/mail/installer/installer.inc.po:	64 vertaalde berichten.
po/sr/mail/installer/mui.properties.po:	43 vertaalde berichten.
po/sr/mail/installer/override.properties.po:	61 vertaalde berichten.
po/sr/mail/installer/custom.properties.po:	49 vertaalde berichten.
po/sr/mail/defines.inc.po:	2 vertaalde berichten.
po/sr/editor/ui/chrome/region/region.properties.po:	1 vertaald bericht.
po/sr/editor/ui/chrome/composer/pref-editing.dtd.po:	15 vertaalde berichten.
po/sr/editor/ui/chrome/composer/editor.dtd.po:	16 vertaalde berichten.
po/sr/editor/ui/chrome/composer/pref-composer.dtd.po:	20 vertaalde berichten.
po/sr/editor/ui/chrome/composer/pref-toolbars.dtd.po:	30 vertaalde berichten.
po/sr/editor/ui/chrome/composer/editorOverlay.dtd.po:	297 vertaalde berichten.
po/sr/editor/ui/chrome/composer/editorNavigatorOverlay.dtd.po:	2 vertaalde berichten.
po/sr/editor/ui/chrome/composer/editor.properties.po:	176 vertaalde berichten.
po/sr/editor/ui/chrome/composer/editorSmileyOverlay.dtd.po:	33 vertaalde berichten.
po/sr/editor/ui/chrome/composer/editorPrefsOverlay.dtd.po:	5 vertaalde berichten.
po/sr/editor/ui/chrome/composer/pref-publish.dtd.po:	8 vertaalde berichten.
po/sr/editor/ui/chrome/dialogs/EditorColorProperties.dtd.po:	14 vertaalde berichten.
po/sr/editor/ui/chrome/dialogs/EdDialogOverlay.dtd.po:	7 vertaalde berichten.
po/sr/editor/ui/chrome/dialogs/EdLinkChecker.dtd.po:	7 vertaalde berichten.
po/sr/editor/ui/chrome/dialogs/EditorFormProperties.dtd.po:	8 vertaalde berichten.
po/sr/editor/ui/chrome/dialogs/EditorButtonProperties.dtd.po:	12 vertaalde berichten.
po/sr/editor/ui/chrome/dialogs/EditorImageMapHotSpot.dtd.po:	13 vertaalde berichten.
po/sr/editor/ui/chrome/dialogs/EditorFieldSetProperties.dtd.po:	9 vertaalde berichten.
po/sr/editor/ui/chrome/dialogs/EditorInsertTable.dtd.po:	8 vertaalde berichten.
po/sr/editor/ui/chrome/dialogs/EdConvertToTable.dtd.po:	9 vertaalde berichten.
po/sr/editor/ui/chrome/dialogs/EditorTextAreaProperties.dtd.po:	17 vertaalde berichten.
po/sr/editor/ui/chrome/dialogs/EditorPublish.dtd.po:	40 vertaalde berichten.
po/sr/editor/ui/chrome/dialogs/EditorPublishProgress.dtd.po:	11 vertaalde berichten.
po/sr/editor/ui/chrome/dialogs/EditorInsertTOC.dtd.po:	13 vertaalde berichten.
po/sr/editor/ui/chrome/dialogs/EditorHLineProperties.dtd.po:	12 vertaalde berichten.
po/sr/editor/ui/chrome/dialogs/EditorLinkProperties.dtd.po:	2 vertaalde berichten.
po/sr/editor/ui/chrome/dialogs/EditorSpellCheck.dtd.po:	18 vertaalde berichten.
po/sr/editor/ui/chrome/dialogs/EdAdvancedEdit.dtd.po:	13 vertaalde berichten.
po/sr/editor/ui/chrome/dialogs/EdColorPicker.dtd.po:	12 vertaalde berichten.
po/sr/editor/ui/chrome/dialogs/EditorInputProperties.dtd.po:	30 vertaalde berichten.
po/sr/editor/ui/chrome/dialogs/EditorTableProperties.dtd.po:	58 vertaalde berichten.
po/sr/editor/ui/chrome/dialogs/EditorInsertSource.dtd.po:	5 vertaalde berichten.
po/sr/editor/ui/chrome/dialogs/EditorPageProperties.dtd.po:	9 vertaalde berichten.
po/sr/editor/ui/chrome/dialogs/EditorImageMap.dtd.po:	40 vertaalde berichten.
po/sr/editor/ui/chrome/dialogs/EdNamedAnchorProperties.dtd.po:	2 vertaalde berichten, 1 vage gelijkenis.
po/sr/editor/ui/chrome/dialogs/EditorPersonalDictionary.dtd.po:	7 vertaalde berichten.
po/sr/editor/ui/chrome/dialogs/EditConflict.dtd.po:	5 vertaalde berichten.
po/sr/editor/ui/chrome/dialogs/EditorSelectProperties.dtd.po:	21 vertaalde berichten.
po/sr/editor/ui/chrome/dialogs/EditorImageProperties.dtd.po:	46 vertaalde berichten.
po/sr/editor/ui/chrome/dialogs/EditorInsertChars.dtd.po:	11 vertaalde berichten.
po/sr/editor/ui/chrome/dialogs/EditorLabelProperties.dtd.po:	6 vertaalde berichten.
po/sr/editor/ui/chrome/dialogs/EditorReplace.dtd.po:	12 vertaalde berichten.
po/sr/editor/ui/chrome/dialogs/EditorSaveAsCharset.dtd.po:	5 vertaalde berichten.
po/sr/editor/ui/chrome/dialogs/EditorListProperties.dtd.po:	11 vertaalde berichten.
po/sr/editor/ui/chrome/dialogs/EditorSnapToGrid.dtd.po:	4 vertaalde berichten.
po/sr/browser/updater/updater.ini.po:	2 vertaalde berichten.
po/sr/browser/crashreporter/crashreporter-override.ini.po:	2 vertaalde berichten.
po/sr/browser/chrome/branding/brand.dtd.po:	po/sr/browser/chrome/branding/brand.dtd.po:22: dubbele definitie van een bericht...
po/sr/browser/chrome/branding/brand.dtd.po:19: ...dit is de plek van de eerste definitie
msgfmt: 1 fatale fout gevonden
po/sr/browser/chrome/branding/brand.properties.po:	po/sr/browser/chrome/branding/brand.properties.po:22: dubbele definitie van een bericht...
po/sr/browser/chrome/branding/brand.properties.po:19: ...dit is de plek van de eerste definitie
msgfmt: 1 fatale fout gevonden
po/sr/browser/chrome/browser-region/region.properties.po:	14 vertaalde berichten.
po/sr/browser/chrome/browser/engineManager.dtd.po:	12 vertaalde berichten.
po/sr/browser/chrome/browser/searchbar.dtd.po:	2 vertaalde berichten.
po/sr/browser/chrome/browser/setDesktopBackground.dtd.po:	9 vertaalde berichten.
po/sr/browser/chrome/browser/openLocation.dtd.po:	8 vertaalde berichten.
po/sr/browser/chrome/browser/aboutRobots.dtd.po:	10 vertaalde berichten.
po/sr/browser/chrome/browser/search.properties.po:	6 vertaalde berichten.
po/sr/browser/chrome/browser/aboutDialog.dtd.po:	po/sr/browser/chrome/browser/aboutDialog.dtd.po: waarschuwing: Charset "CHARSET" is not a portable encoding name.
                                                               Message conversion to user's charset might not work.
9 vertaalde berichten.
po/sr/browser/chrome/browser/openLocation.properties.po:	1 vertaald bericht.
po/sr/browser/chrome/browser/tabbrowser.dtd.po:	10 vertaalde berichten.
po/sr/browser/chrome/browser/browser.dtd.po:	197 vertaalde berichten, 3 onvertaalde berichten.
po/sr/browser/chrome/browser/history/history.dtd.po:	14 vertaalde berichten.
po/sr/browser/chrome/browser/sanitize.dtd.po:	10 vertaalde berichten.
po/sr/browser/chrome/browser/migration/migration.dtd.po:	28 vertaalde berichten.
po/sr/browser/chrome/browser/migration/migration.properties.po:	30 vertaalde berichten.
po/sr/browser/chrome/browser/aboutCertError.dtd.po:	13 vertaalde berichten.
po/sr/browser/chrome/browser/credits.dtd.po:	7 vertaalde berichten.
po/sr/browser/chrome/browser/metaData.dtd.po:	25 vertaalde berichten.
po/sr/browser/chrome/browser/sidebar/sidebar.properties.po:	2 vertaalde berichten.
po/sr/browser/chrome/browser/pageReport.dtd.po:	4 vertaalde berichten.
po/sr/browser/chrome/browser/feeds/subscribe.dtd.po:	3 vertaalde berichten.
po/sr/browser/chrome/browser/feeds/subscribe.properties.po:	31 vertaalde berichten.
po/sr/browser/chrome/browser/pageInfo.dtd.po:	69 vertaalde berichten.
po/sr/browser/chrome/browser/preferences/content.dtd.po:	15 vertaalde berichten.
po/sr/browser/chrome/browser/preferences/preferences.dtd.po:	12 vertaalde berichten.
po/sr/browser/chrome/browser/preferences/preferences.properties.po:	66 vertaalde berichten.
po/sr/browser/chrome/browser/preferences/tabs.dtd.po:	7 vertaalde berichten.
po/sr/browser/chrome/browser/preferences/fallbackEULA.dtd.po:	1 vertaald bericht.
po/sr/browser/chrome/browser/preferences/applications.dtd.po:	6 vertaalde berichten.
po/sr/browser/chrome/browser/preferences/colors.dtd.po:	12 vertaalde berichten.
po/sr/browser/chrome/browser/preferences/advanced.dtd.po:	51 vertaalde berichten.
po/sr/browser/chrome/browser/preferences/phishEULA.dtd.po:	7 vertaalde berichten.
po/sr/browser/chrome/browser/preferences/advanced-scripts.dtd.po:	9 vertaalde berichten.
po/sr/browser/chrome/browser/preferences/languages.dtd.po:	9 vertaalde berichten.
po/sr/browser/chrome/browser/preferences/security.dtd.po:	13 vertaalde berichten.
po/sr/browser/chrome/browser/preferences/securityWarnings.dtd.po:	7 vertaalde berichten.
po/sr/browser/chrome/browser/preferences/cookies.dtd.po:	18 vertaalde berichten.
po/sr/browser/chrome/browser/preferences/connection.dtd.po:	25 vertaalde berichten, 1 onvertaald bericht.
po/sr/browser/chrome/browser/preferences/selectBookmark.dtd.po:	2 vertaalde berichten.
po/sr/browser/chrome/browser/preferences/fonts.dtd.po:	50 vertaalde berichten.
po/sr/browser/chrome/browser/preferences/applicationManager.properties.po:	6 vertaalde berichten.
po/sr/browser/chrome/browser/preferences/applicationManager.dtd.po:	3 vertaalde berichten.
po/sr/browser/chrome/browser/preferences/permissions.dtd.po:	12 vertaalde berichten.
po/sr/browser/chrome/browser/preferences/privacy.dtd.po:	20 vertaalde berichten.
po/sr/browser/chrome/browser/preferences/main.dtd.po:	21 vertaalde berichten.
po/sr/browser/chrome/browser/baseMenuOverlay.dtd.po:	25 vertaalde berichten.
po/sr/browser/chrome/browser/browser.properties.po:	100 vertaalde berichten.
po/sr/browser/chrome/browser/sessionstore.properties.po:	4 vertaalde berichten.
po/sr/browser/chrome/browser/engineManager.properties.po:	5 vertaalde berichten.
po/sr/browser/chrome/browser/places/bookmarkProperties.properties.po:	12 vertaalde berichten.
po/sr/browser/chrome/browser/places/bookmarkProperties.dtd.po:	12 vertaalde berichten.
po/sr/browser/chrome/browser/places/moveBookmarks.dtd.po:	4 vertaalde berichten.
po/sr/browser/chrome/browser/places/places.dtd.po:	129 vertaalde berichten.
po/sr/browser/chrome/browser/places/places.properties.po:	83 vertaalde berichten.
po/sr/browser/chrome/browser/places/editBookmarkOverlay.dtd.po:	15 vertaalde berichten.
po/sr/browser/chrome/browser/tabbrowser.properties.po:	10 vertaalde berichten.
po/sr/browser/chrome/browser/metaData.properties.po:	16 vertaalde berichten.
po/sr/browser/chrome/browser/aboutPrivateBrowsing.dtd.po:	8 vertaalde berichten.
po/sr/browser/chrome/browser/pageInfo.properties.po:	38 vertaalde berichten.
po/sr/browser/chrome/browser/safeMode.dtd.po:	11 vertaalde berichten.
po/sr/browser/chrome/browser/safebrowsing/phishing-afterload-warning-message.dtd.po:	20 vertaalde berichten.
po/sr/browser/chrome/browser/safebrowsing/blockedSite.properties.po:	6 vertaalde berichten.
po/sr/browser/chrome/browser/safebrowsing/report-phishing.dtd.po:	2 vertaalde berichten.
po/sr/browser/chrome/browser/quitDialog.properties.po:	10 vertaalde berichten.
po/sr/browser/chrome/browser/pageReportFirstTime.dtd.po:	4 vertaalde berichten.
po/sr/browser/chrome/browser/shellservice.properties.po:	9 vertaalde berichten.
po/sr/browser/chrome/overrides/netError.dtd.po:	43 vertaalde berichten, 1 onvertaald bericht.
po/sr/browser/chrome/overrides/settingsChange.dtd.po:	2 vertaalde berichten.
po/sr/browser/chrome/overrides/appstrings.properties.po:	26 vertaalde berichten.
po/sr/browser/installer/mui.properties.po:	43 vertaalde berichten.
po/sr/browser/installer/override.properties.po:	61 vertaalde berichten.
po/sr/browser/installer/custom.properties.po:	48 vertaalde berichten.
po/sr/browser/defines.inc.po:	2 vertaalde berichten.
po/sr/other-licenses/branding/firefox/brand.dtd.po:	3 vertaalde berichten.
po/sr/other-licenses/branding/firefox/brand.properties.po:	7 vertaalde berichten.
po/sr/other-licenses/branding/thunderbird/brand.dtd.po:	3 vertaalde berichten.
po/sr/other-licenses/branding/thunderbird/brand.properties.po:	3 vertaalde berichten.
po/sr/extensions/reporter/chrome/reporterOverlay.dtd.po:	4 vertaalde berichten.
po/sr/extensions/reporter/chrome/reportResults.dtd.po:	15 vertaalde berichten.
po/sr/extensions/reporter/chrome/reportWizard.properties.po:	9 vertaalde berichten.
po/sr/extensions/reporter/chrome/reportWizard.dtd.po:	33 vertaalde berichten.
po/sr/extensions/reporter/chrome/about.dtd.po:	3 vertaalde berichten.
po/sr/extensions/reporter/chrome/reporter.dtd.po:	2 vertaalde berichten.
po/sr/extensions/irc/chrome/channels.dtd.po:	po/sr/extensions/irc/chrome/channels.dtd.po:82: 'msgid' en 'msgstr' eindigen niet beide met '
'
msgfmt: 1 fatale fout gevonden
11 vertaalde berichten.
po/sr/extensions/irc/chrome/chatzilla.properties.po:	167 vertaalde berichten, 999 onvertaalde berichten.
po/sr/extensions/irc/chrome/config.dtd.po:	21 vertaalde berichten.
po/sr/extensions/irc/chrome/chatzillaOverlay.dtd.po:	2 vertaalde berichten.
po/sr/extensions/irc/chrome/pref-irc.dtd.po:	5 vertaalde berichten.
po/sr/extensions/irc/chrome/chatzilla.dtd.po:	12 vertaalde berichten.
po/sr/extensions/irc/chrome/browserOverlay.dtd.po:	2 vertaalde berichten.
po/sr/extensions/irc/defines.inc.po:	3 vertaalde berichten.
po/sr/extensions/metrics/prefs.dtd.po:	4 vertaalde berichten.
po/sr/extensions/cck/browser/chrome/cckwizard.properties.po:	21 vertaalde berichten.
po/sr/extensions/cck/browser/chrome/cckWizard.dtd.po:	165 vertaalde berichten.
po/sr/extensions/wallet/resources/walletNavigatorOverlay.dtd.po:	12 vertaalde berichten.
po/sr/extensions/wallet/resources/walletPrefsOverlay.dtd.po:	2 vertaalde berichten.
po/sr/extensions/wallet/resources/walletTasksOverlay.dtd.po:	15 vertaalde berichten.
po/sr/extensions/wallet/resources/pref-wallet.dtd.po:	6 vertaalde berichten.
po/sr/extensions/wallet/resources/pref-passwords.dtd.po:	8 vertaalde berichten.
po/sr/extensions/cview/resources/cviewOverlay.dtd.po:	1 vertaald bericht.
po/sr/extensions/venkman/chrome/venkman-overlay.dtd.po:	3 vertaalde berichten.
po/sr/extensions/venkman/chrome/venkman.dtd.po:	46 vertaalde berichten.
po/sr/extensions/venkman/chrome/venkman.properties.po:	581 vertaalde berichten, 15 onvertaalde berichten.
po/sr/extensions/venkman/defines.inc.po:	po/sr/extensions/venkman/defines.inc.po:31: 'msgid' en 'msgstr' eindigen niet beide met '
'
msgfmt: 1 fatale fout gevonden
3 vertaalde berichten.
po/sr/extensions/signonviewer/resources/SignonViewer.properties.po:	7 vertaalde berichten.
po/sr/extensions/signonviewer/resources/SignonViewer.dtd.po:	16 vertaalde berichten.
po/sr/dom/chrome/accessibility/unix/accessible.properties.po:	13 vertaalde berichten.
po/sr/dom/chrome/accessibility/win/accessible.properties.po:	13 vertaalde berichten.
po/sr/dom/chrome/accessibility/mac/accessible.properties.po:	13 vertaalde berichten.
po/sr/dom/chrome/netErrorApp.dtd.po:	2 vertaalde berichten.
po/sr/dom/chrome/prompts.properties.po:	4 vertaalde berichten.
po/sr/dom/chrome/security/caps.properties.po:	25 vertaalde berichten.
po/sr/dom/chrome/xml/prettyprint.dtd.po:	1 vertaald bericht.
po/sr/dom/chrome/netError.dtd.po:	42 vertaalde berichten, 1 vage gelijkenis.
po/sr/dom/chrome/webservices/security.properties.po:	8 vertaalde berichten.
po/sr/dom/chrome/charsetTitles.properties.po:	99 vertaalde berichten.
po/sr/dom/chrome/printdialog.properties.po:	5 vertaalde berichten.
po/sr/dom/chrome/dom/dom.properties.po:	24 vertaalde berichten.
po/sr/dom/chrome/global.dtd.po:	1 vertaald bericht.
po/sr/dom/chrome/xslt/xslt.properties.po:	32 vertaalde berichten, 1 onvertaald bericht.
po/sr/dom/chrome/storage.properties.po:	1 vertaald bericht.
po/sr/dom/chrome/global-strres.properties.po:	1 vertaald bericht.
po/sr/dom/chrome/plugins.properties.po:	12 vertaalde berichten.
po/sr/dom/chrome/layout/layout_errors.properties.po:	5 vertaalde berichten.
po/sr/dom/chrome/layout/xul.properties.po:	4 vertaalde berichten.
po/sr/dom/chrome/layout/xmlparser.properties.po:	35 vertaalde berichten.
po/sr/dom/chrome/layout/css.properties.po:	100 vertaalde berichten.
po/sr/dom/chrome/layout/HtmlForm.properties.po:	8 vertaalde berichten.
po/sr/dom/chrome/layout/MediaDocument.properties.po:	9 vertaalde berichten.
po/sr/dom/chrome/layout/xbl.properties.po:	6 vertaalde berichten.
po/sr/dom/chrome/layout/printing.properties.po:	47 vertaalde berichten.
po/sr/dom/chrome/nsWebBrowserPersist.properties.po:	11 vertaalde berichten.
po/sr/dom/chrome/svg/svg.properties.po:	1 vertaald bericht.
po/sr/dom/chrome/appstrings.properties.po:	26 vertaalde berichten.
po/sr/netwerk/necko.properties.po:	25 vertaalde berichten.
po/sr/toolkit/crashreporter/crashes.properties.po:	2 vertaalde berichten.
po/sr/toolkit/crashreporter/crashreporter.ini.po:	37 vertaalde berichten, 1 onvertaald bericht.
po/sr/toolkit/crashreporter/crashes.dtd.po:	6 vertaalde berichten.
po/sr/toolkit/chrome/alerts/notificationNames.properties.po:	1 vertaald bericht.
po/sr/toolkit/chrome/autoconfig/autoconfig.properties.po:	6 vertaalde berichten.
po/sr/toolkit/chrome/search/search.properties.po:	10 vertaalde berichten.
po/sr/toolkit/chrome/global-platform/unix/platformKeys.properties.po:	5 vertaalde berichten.
po/sr/toolkit/chrome/global-platform/unix/intl.properties.po:	2 vertaalde berichten.
po/sr/toolkit/chrome/global-platform/win/platformKeys.properties.po:	5 vertaalde berichten.
po/sr/toolkit/chrome/global-platform/win/intl.properties.po:	2 vertaalde berichten.
po/sr/toolkit/chrome/global-platform/mac/platformKeys.properties.po:	4 vertaalde berichten, 1 onvertaald bericht.
po/sr/toolkit/chrome/global-platform/mac/intl.properties.po:	2 vertaalde berichten.
po/sr/toolkit/chrome/global/nsProgressDialog.properties.po:	4 vertaalde berichten.
po/sr/toolkit/chrome/global/dialogOverlay.dtd.po:	3 vertaalde berichten.
po/sr/toolkit/chrome/global/preferences.dtd.po:	4 vertaalde berichten.
po/sr/toolkit/chrome/global/wizard.dtd.po:	9 vertaalde berichten.
po/sr/toolkit/chrome/global/finddialog.properties.po:	2 vertaalde berichten.
po/sr/toolkit/chrome/global/finddialog.dtd.po:	10 vertaalde berichten.
po/sr/toolkit/chrome/global/findbar.dtd.po:	8 vertaalde berichten.
po/sr/toolkit/chrome/global/license.dtd.po:	5 vertaalde berichten.
po/sr/toolkit/chrome/global/dialog.properties.po:	4 vertaalde berichten, 4 onvertaalde berichten.
po/sr/toolkit/chrome/global/appPicker.dtd.po:	3 vertaalde berichten.
po/sr/toolkit/chrome/global/filepicker.dtd.po:	11 vertaalde berichten.
po/sr/toolkit/chrome/global/history/history.properties.po:	10 vertaalde berichten.
po/sr/toolkit/chrome/global/commonDialogs.properties.po:	15 vertaalde berichten.
po/sr/toolkit/chrome/global/datetimepicker.dtd.po:	1 vertaald bericht.
po/sr/toolkit/chrome/global/keys.properties.po:	35 vertaalde berichten.
po/sr/toolkit/chrome/global/contentAreaCommands.properties.po:	9 vertaalde berichten.
po/sr/toolkit/chrome/global/wizard.properties.po:	4 vertaalde berichten.
po/sr/toolkit/chrome/global/config.dtd.po:	23 vertaalde berichten.
po/sr/toolkit/chrome/global/editMenuOverlay.dtd.po:	20 vertaalde berichten.
po/sr/toolkit/chrome/global/viewSource.dtd.po:	30 vertaalde berichten, 3 onvertaalde berichten.
po/sr/toolkit/chrome/global/console.properties.po:	6 vertaalde berichten.
po/sr/toolkit/chrome/global/config.properties.po:	9 vertaalde berichten.
po/sr/toolkit/chrome/global/charsetOverlay.dtd.po:	10 vertaalde berichten.
po/sr/toolkit/chrome/global/printjoboptions.dtd.po:	17 vertaalde berichten.
po/sr/toolkit/chrome/global/customizeToolbar.properties.po:	7 vertaalde berichten.
po/sr/toolkit/chrome/global/notification.dtd.po:	1 vertaald bericht.
po/sr/toolkit/chrome/global/customizeToolbar.dtd.po:	12 vertaalde berichten.
po/sr/toolkit/chrome/global/findbar.properties.po:	10 vertaalde berichten.
po/sr/toolkit/chrome/global/console.dtd.po:	18 vertaalde berichten.
po/sr/toolkit/chrome/global/printProgress.dtd.po:	8 vertaalde berichten.
po/sr/toolkit/chrome/global/printdialog.dtd.po:	19 vertaalde berichten.
po/sr/toolkit/chrome/global/tree.dtd.po:	1 vertaald bericht.
po/sr/toolkit/chrome/global/intl.properties.po:	14 vertaalde berichten, 2 onvertaalde berichten.
po/sr/toolkit/chrome/global/printPageSetup.dtd.po:	35 vertaalde berichten.
po/sr/toolkit/chrome/global/gnomeprintdialog.properties.po:	23 vertaalde berichten.
po/sr/toolkit/chrome/global/nsTreeSorting.properties.po:	1 vertaald bericht.
po/sr/toolkit/chrome/global/browser.properties.po:	4 vertaalde berichten.
po/sr/toolkit/chrome/global/downloadProgress.properties.po:	3 vertaalde berichten.
po/sr/toolkit/chrome/global/nsHelperAppDlg.dtd.po:	17 vertaalde berichten.
po/sr/toolkit/chrome/global/regionNames.properties.po:	246 vertaalde berichten.
po/sr/toolkit/chrome/global/printPreview.dtd.po:	27 vertaalde berichten.
po/sr/toolkit/chrome/global/printPreviewProgress.dtd.po:	4 vertaalde berichten.
po/sr/toolkit/chrome/global/commonDialog.dtd.po:	8 vertaalde berichten.
po/sr/toolkit/chrome/global/viewSource.properties.po:	9 vertaalde berichten.
po/sr/toolkit/chrome/global/mozilla.dtd.po:	po/sr/toolkit/chrome/global/mozilla.dtd.po: waarschuwing: Charset "CHARSET" is not a portable encoding name.
                                                          Message conversion to user's charset might not work.
3 vertaalde berichten.
po/sr/toolkit/chrome/global/filepicker.properties.po:	40 vertaalde berichten.
po/sr/toolkit/chrome/global/customizeCharset.dtd.po:	7 vertaalde berichten.
po/sr/toolkit/chrome/global/about.dtd.po:	13 vertaalde berichten.
po/sr/toolkit/chrome/global/nsHelperAppDlg.properties.po:	2 vertaalde berichten.
po/sr/toolkit/chrome/global/languageNames.properties.po:	193 vertaalde berichten.
po/sr/toolkit/chrome/global/xpinstall/xpinstall.properties.po:	64 vertaalde berichten.
po/sr/toolkit/chrome/global/nsProgressDialog.dtd.po:	27 vertaalde berichten.
po/sr/toolkit/chrome/global/textcontext.dtd.po:	10 vertaalde berichten.
po/sr/toolkit/chrome/global-region/region.properties.po:	5 vertaalde berichten.
po/sr/toolkit/chrome/global-region/region.dtd.po:	1 vertaald bericht.
po/sr/toolkit/chrome/passwordmgr/passwordManager.dtd.po:	13 vertaalde berichten.
po/sr/toolkit/chrome/passwordmgr/passwordmgr.properties.po:	29 vertaalde berichten.
po/sr/toolkit/chrome/places/places.properties.po:	12 vertaalde berichten.
po/sr/toolkit/chrome/cookie/cookieAcceptDialog.properties.po:	14 vertaalde berichten.
po/sr/toolkit/chrome/cookie/cookieAcceptDialog.dtd.po:	12 vertaalde berichten.
po/sr/toolkit/chrome/mozapps/downloads/downloads.dtd.po:	27 vertaalde berichten.
po/sr/toolkit/chrome/mozapps/downloads/unknownContentType.dtd.po:	11 vertaalde berichten.
po/sr/toolkit/chrome/mozapps/downloads/unknownContentType.properties.po:	20 vertaalde berichten.
po/sr/toolkit/chrome/mozapps/downloads/downloads.properties.po:	64 vertaalde berichten.
po/sr/toolkit/chrome/mozapps/downloads/settingsChange.dtd.po:	2 vertaalde berichten.
po/sr/toolkit/chrome/mozapps/handling/handling.dtd.po:	3 vertaalde berichten.
po/sr/toolkit/chrome/mozapps/handling/handling.properties.po:	7 vertaalde berichten.
po/sr/toolkit/chrome/mozapps/update/history.dtd.po:	8 vertaalde berichten.
po/sr/toolkit/chrome/mozapps/update/updates.properties.po:	81 vertaalde berichten.
po/sr/toolkit/chrome/mozapps/update/incompatible.dtd.po:	5 vertaalde berichten.
po/sr/toolkit/chrome/mozapps/update/errors.dtd.po:	1 vertaald bericht.
po/sr/toolkit/chrome/mozapps/update/updates.dtd.po:	0 vertaalde berichten.
po/sr/toolkit/chrome/mozapps/help/welcome.xhtml.po:	13 vertaalde berichten.
po/sr/toolkit/chrome/mozapps/help/help.properties.po:	1 vertaald bericht.
po/sr/toolkit/chrome/mozapps/help/help.dtd.po:	28 vertaalde berichten, 3 onvertaalde berichten.
po/sr/toolkit/chrome/mozapps/extensions/extensions.properties.po:	97 vertaalde berichten.
po/sr/toolkit/chrome/mozapps/extensions/extensions.dtd.po:	116 vertaalde berichten.
po/sr/toolkit/chrome/mozapps/extensions/update.properties.po:	po/sr/toolkit/chrome/mozapps/extensions/update.properties.po:26: dubbele definitie van een bericht...
po/sr/toolkit/chrome/mozapps/extensions/update.properties.po:23: ...dit is de plek van de eerste definitie
msgfmt: 1 fatale fout gevonden
po/sr/toolkit/chrome/mozapps/extensions/update.dtd.po:	34 vertaalde berichten.
po/sr/toolkit/chrome/mozapps/extensions/about.dtd.po:	5 vertaalde berichten.
po/sr/toolkit/chrome/mozapps/preferences/ocsp.dtd.po:	7 vertaalde berichten.
po/sr/toolkit/chrome/mozapps/preferences/preferences.properties.po:	12 vertaalde berichten.
po/sr/toolkit/chrome/mozapps/preferences/changemp.dtd.po:	9 vertaalde berichten.
po/sr/toolkit/chrome/mozapps/preferences/removemp.dtd.po:	5 vertaalde berichten.
po/sr/toolkit/chrome/mozapps/plugins/plugins.dtd.po:	16 vertaalde berichten.
po/sr/toolkit/chrome/mozapps/plugins/plugins.properties.po:	21 vertaalde berichten.
po/sr/toolkit/chrome/mozapps/profile/profileSelection.dtd.po:	11 vertaalde berichten.
po/sr/toolkit/chrome/mozapps/profile/createProfileWizard.dtd.po:	13 vertaalde berichten.
po/sr/toolkit/chrome/mozapps/profile/profileSelection.properties.po:	27 vertaalde berichten.
po/sr/toolkit/chrome/mozapps/xpinstall/xpinstallConfirm.properties.po:	9 vertaalde berichten.
po/sr/toolkit/chrome/mozapps/xpinstall/xpinstallConfirm.dtd.po:	5 vertaalde berichten.
po/sr/toolkit/defines.inc.po:	1 vertaald bericht.
