po/sr-RS/security/manager/chrome/pipnss/nsserrors.properties.po:	0 translated messages, 264 untranslated messages.
po/sr-RS/security/manager/chrome/pipnss/security.properties.po:	15 translated messages.
po/sr-RS/security/manager/chrome/pipnss/pipnss.properties.po:	291 translated messages, 34 untranslated messages.
po/sr-RS/security/manager/chrome/pippki/deviceManager.dtd.po:	22 translated messages.
po/sr-RS/security/manager/chrome/pippki/pref-ssl.dtd.po:	26 translated messages.
po/sr-RS/security/manager/chrome/pippki/certManager.dtd.po:	48 translated messages, 30 untranslated messages.
po/sr-RS/security/manager/chrome/pippki/pref-validation.dtd.po:	39 translated messages.
po/sr-RS/security/manager/chrome/pippki/pref-masterpass.dtd.po:	18 translated messages.
po/sr-RS/security/manager/chrome/pippki/newserver.dtd.po:	9 translated messages.
po/sr-RS/security/manager/chrome/pippki/pippki.properties.po:	105 translated messages, 36 untranslated messages.
po/sr-RS/security/manager/chrome/pippki/pref-security.dtd.po:	12 translated messages.
po/sr-RS/security/manager/chrome/pippki/PrefOverlay.dtd.po:	5 translated messages.
po/sr-RS/security/manager/chrome/pippki/pippki.dtd.po:	62 translated messages.
po/sr-RS/security/manager/chrome/pippki/PageInfoOverlay.dtd.po:	4 translated messages.
po/sr-RS/security/manager/chrome/pippki/newserver.properties.po:	3 translated messages.
po/sr-RS/mail/updater/updater.ini.po:	2 translated messages.
po/sr-RS/mail/chrome/branding/brand.dtd.po:	3 translated messages.
po/sr-RS/mail/chrome/branding/brand.properties.po:	3 translated messages.
po/sr-RS/mail/chrome/messenger-mapi/mapi.properties.po:	17 translated messages.
po/sr-RS/mail/chrome/mozldap/ldap.properties.po:	62 translated messages.
po/sr-RS/mail/chrome/global-platform/win/nsWindowsHooks.properties.po:	6 translated messages.
po/sr-RS/mail/chrome/messenger-smime/msgReadSMIMEOverlay.dtd.po:	1 translated message.
po/sr-RS/mail/chrome/messenger-smime/msgReadSMIMEOverlay.properties.po:	3 translated messages.
po/sr-RS/mail/chrome/messenger-smime/certFetchingStatus.dtd.po:	3 translated messages.
po/sr-RS/mail/chrome/messenger-smime/msgReadSecurityInfo.dtd.po:	7 translated messages.
po/sr-RS/mail/chrome/messenger-smime/msgCompSecurityInfo.properties.po:	9 translated messages.
po/sr-RS/mail/chrome/messenger-smime/msgCompSMIMEOverlay.dtd.po:	9 translated messages.
po/sr-RS/mail/chrome/messenger-smime/msgCompSecurityInfo.dtd.po:	11 translated messages.
po/sr-RS/mail/chrome/messenger-smime/msgSecurityInfo.properties.po:	50 translated messages.
po/sr-RS/mail/chrome/messenger-smime/msgCompSMIMEOverlay.properties.po:	1 translated message.
po/sr-RS/mail/chrome/communicator/contentAreaCommands.dtd.po:	po/sr-RS/mail/chrome/communicator/contentAreaCommands.dtd.po:26: `msgid' en `msgstr' ingangen eindigen niet allebei met '
'
po/sr-RS/mail/chrome/communicator/contentAreaCommands.dtd.po:36: `msgid' en `msgstr' ingangen eindigen niet allebei met '
'
msgfmt: found 2 fatal errors
60 translated messages.
po/sr-RS/mail/chrome/communicator/contentAreaCommands.properties.po:	13 translated messages.
po/sr-RS/mail/chrome/communicator/wallet/SignonViewer.properties.po:	8 translated messages.
po/sr-RS/mail/chrome/communicator/wallet/wallet.properties.po:	41 translated messages.
po/sr-RS/mail/chrome/communicator/wallet/SignonViewer.dtd.po:	15 translated messages.
po/sr-RS/mail/chrome/communicator/utilityOverlay.properties.po:	5 translated messages.
po/sr-RS/mail/chrome/communicator/utilityOverlay.dtd.po:	36 translated messages.
po/sr-RS/mail/chrome/global/charset.dtd.po:	10 translated messages.
po/sr-RS/mail/chrome/messenger/importMsgs.properties.po:	87 translated messages.
po/sr-RS/mail/chrome/messenger/markByDate.dtd.po:	3 translated messages.
po/sr-RS/mail/chrome/messenger/comm4xMailImportMsgs.properties.po:	5 translated messages.
po/sr-RS/mail/chrome/messenger/msgViewPickerOverlay.dtd.po:	7 translated messages.
po/sr-RS/mail/chrome/messenger/messengercompose/askSendFormat.properties.po:	4 translated messages.
po/sr-RS/mail/chrome/messenger/messengercompose/sendProgress.properties.po:	5 translated messages.
po/sr-RS/mail/chrome/messenger/messengercompose/addressingWidgetOverlay.dtd.po:	6 translated messages.
po/sr-RS/mail/chrome/messenger/messengercompose/askSendFormat.dtd.po:	7 translated messages.
po/sr-RS/mail/chrome/messenger/messengercompose/messengercompose.dtd.po:	119 translated messages, 34 untranslated messages.
po/sr-RS/mail/chrome/messenger/messengercompose/composeMsgs.properties.po:	74 translated messages, 34 untranslated messages.
po/sr-RS/mail/chrome/messenger/messengercompose/mailComposeEditorOverlay.dtd.po:	2 translated messages.
po/sr-RS/mail/chrome/messenger/messengercompose/sendProgress.dtd.po:	3 translated messages.
po/sr-RS/mail/chrome/messenger/subscribe.dtd.po:	8 translated messages.
po/sr-RS/mail/chrome/messenger/folderpane.dtd.po:	5 translated messages.
po/sr-RS/mail/chrome/messenger/am-copies.dtd.po:	17 translated messages.
po/sr-RS/mail/chrome/messenger/searchTermOverlay.dtd.po:	5 translated messages.
po/sr-RS/mail/chrome/messenger/search.properties.po:	10 translated messages.
po/sr-RS/mail/chrome/messenger/aboutDialog.dtd.po:	5 translated messages.
po/sr-RS/mail/chrome/messenger/am-addressing.dtd.po:	16 translated messages.
po/sr-RS/mail/chrome/messenger/filter.properties.po:	38 translated messages.
po/sr-RS/mail/chrome/messenger/mailviews.properties.po:	5 translated messages.
po/sr-RS/mail/chrome/messenger/AccountManager.dtd.po:	9 translated messages.
po/sr-RS/mail/chrome/messenger/downloadheaders.dtd.po:	4 translated messages.
po/sr-RS/mail/chrome/messenger/fieldMapExport.dtd.po:	4 translated messages.
po/sr-RS/mail/chrome/messenger/threadpane.dtd.po:	36 translated messages.
po/sr-RS/mail/chrome/messenger/am-server-top.dtd.po:	51 translated messages.
po/sr-RS/mail/chrome/messenger/SearchDialog.dtd.po:	58 translated messages.
po/sr-RS/mail/chrome/messenger/msgHdrViewOverlay.dtd.po:	29 translated messages.
po/sr-RS/mail/chrome/messenger/migration/migration.dtd.po:	18 translated messages.
po/sr-RS/mail/chrome/messenger/migration/migration.properties.po:	16 translated messages.
po/sr-RS/mail/chrome/messenger/virtualFolderName.dtd.po:	2 translated messages.
po/sr-RS/mail/chrome/messenger/folderProps.dtd.po:	34 translated messages.
po/sr-RS/mail/chrome/messenger/mailViewSetup.dtd.po:	3 translated messages.
po/sr-RS/mail/chrome/messenger/prefs.properties.po:	38 translated messages.
po/sr-RS/mail/chrome/messenger/vcard.properties.po:	62 translated messages.
po/sr-RS/mail/chrome/messenger/smime.properties.po:	1 translated message.
po/sr-RS/mail/chrome/messenger/am-smime.dtd.po:	16 translated messages.
po/sr-RS/mail/chrome/messenger/search-operators.properties.po:	18 translated messages.
po/sr-RS/mail/chrome/messenger/virtualFolderListDialog.dtd.po:	2 translated messages.
po/sr-RS/mail/chrome/messenger/mailEditorOverlay.dtd.po:	1 translated message.
po/sr-RS/mail/chrome/messenger/tabmail.dtd.po:	7 translated messages.
po/sr-RS/mail/chrome/messenger/imapMsgs.properties.po:	85 translated messages, 1 untranslated message.
po/sr-RS/mail/chrome/messenger/localMsgs.properties.po:	41 translated messages.
po/sr-RS/mail/chrome/messenger/am-offline.dtd.po:	23 translated messages.
po/sr-RS/mail/chrome/messenger/subscribe.properties.po:	6 translated messages.
po/sr-RS/mail/chrome/messenger/credits.dtd.po:	23 translated messages.
po/sr-RS/mail/chrome/messenger/am-server-advanced.dtd.po:	18 translated messages.
po/sr-RS/mail/chrome/messenger/smtpEditOverlay.dtd.po:	15 translated messages.
po/sr-RS/mail/chrome/messenger/msgFolderPickerOverlay.dtd.po:	9 translated messages.
po/sr-RS/mail/chrome/messenger/msgSynchronize.dtd.po:	12 translated messages.
po/sr-RS/mail/chrome/messenger/mimeheader.properties.po:	25 translated messages.
po/sr-RS/mail/chrome/messenger/outlookImportMsgs.properties.po:	9 translated messages.
po/sr-RS/mail/chrome/messenger/offline.properties.po:	11 translated messages.
po/sr-RS/mail/chrome/messenger/mailTurboMenu.properties.po:	2 translated messages.
po/sr-RS/mail/chrome/messenger/mime.properties.po:	46 translated messages.
po/sr-RS/mail/chrome/messenger/am-junk.dtd.po:	10 translated messages.
po/sr-RS/mail/chrome/messenger/eudoraImportMsgs.properties.po:	26 translated messages.
po/sr-RS/mail/chrome/messenger/offlineStartup.properties.po:	3 translated messages.
po/sr-RS/mail/chrome/messenger/viewLog.dtd.po:	5 translated messages.
po/sr-RS/mail/chrome/messenger/FilterEditor.dtd.po:	27 translated messages.
po/sr-RS/mail/chrome/messenger/newTagDialog.dtd.po:	2 translated messages.
po/sr-RS/mail/chrome/messenger/oeImportMsgs.properties.po:	10 translated messages.
po/sr-RS/mail/chrome/messenger/preferences/junkLog.dtd.po:	4 translated messages.
po/sr-RS/mail/chrome/messenger/preferences/preferences.dtd.po:	12 translated messages.
po/sr-RS/mail/chrome/messenger/preferences/preferences.properties.po:	43 translated messages.
po/sr-RS/mail/chrome/messenger/preferences/changeaction.dtd.po:	12 translated messages.
po/sr-RS/mail/chrome/messenger/preferences/downloadactions.dtd.po:	16 translated messages.
po/sr-RS/mail/chrome/messenger/preferences/general.dtd.po:	21 translated messages.
po/sr-RS/mail/chrome/messenger/preferences/advanced.dtd.po:	47 translated messages.
po/sr-RS/mail/chrome/messenger/preferences/downloads.dtd.po:	14 translated messages.
po/sr-RS/mail/chrome/messenger/preferences/viewpasswords.dtd.po:	10 translated messages.
po/sr-RS/mail/chrome/messenger/preferences/htmlcompose.dtd.po:	8 translated messages.
po/sr-RS/mail/chrome/messenger/preferences/sendoptions.dtd.po:	24 translated messages.
po/sr-RS/mail/chrome/messenger/preferences/compose.dtd.po:	38 translated messages.
po/sr-RS/mail/chrome/messenger/preferences/offline.dtd.po:	13 translated messages.
po/sr-RS/mail/chrome/messenger/preferences/connection.dtd.po:	21 translated messages.
po/sr-RS/mail/chrome/messenger/preferences/notifications.dtd.po:	6 translated messages.
po/sr-RS/mail/chrome/messenger/preferences/fonts.dtd.po:	53 translated messages.
po/sr-RS/mail/chrome/messenger/preferences/display.dtd.po:	32 translated messages.
po/sr-RS/mail/chrome/messenger/preferences/privacy.dtd.po:	27 translated messages.
po/sr-RS/mail/chrome/messenger/preferences/receipts.dtd.po:	14 translated messages.
po/sr-RS/mail/chrome/messenger/am-serverwithnoidentities.dtd.po:	8 translated messages.
po/sr-RS/mail/chrome/messenger/defaultClientDialog.dtd.po:	6 translated messages.
po/sr-RS/mail/chrome/messenger/msgmdn.properties.po:	14 translated messages.
po/sr-RS/mail/chrome/messenger/importDialog.dtd.po:	25 translated messages.
po/sr-RS/mail/chrome/messenger/am-dsn.properties.po:	1 translated message.
po/sr-RS/mail/chrome/messenger/news.properties.po:	26 translated messages.
po/sr-RS/mail/chrome/messenger/AccountWizard.dtd.po:	56 translated messages.
po/sr-RS/mail/chrome/messenger/am-mdn.dtd.po:	16 translated messages.
po/sr-RS/mail/chrome/messenger/messenger.dtd.po:	277 translated messages, 79 untranslated messages.
po/sr-RS/mail/chrome/messenger/start.dtd.po:	16 translated messages, 8 untranslated messages.
po/sr-RS/mail/chrome/messenger/am-identity-edit.dtd.po:	5 translated messages.
po/sr-RS/mail/chrome/messenger/fieldMapImport.dtd.po:	5 translated messages, 6 untranslated messages.
po/sr-RS/mail/chrome/messenger/am-advanced.dtd.po:	9 translated messages, 3 untranslated messages.
po/sr-RS/mail/chrome/messenger/custom.properties.po:	2 translated messages.
po/sr-RS/mail/chrome/messenger/newFolderDialog.dtd.po:	7 translated messages.
po/sr-RS/mail/chrome/messenger/virtualFolderProperties.dtd.po:	5 translated messages, 2 untranslated messages.
po/sr-RS/mail/chrome/messenger/search-attributes.properties.po:	37 translated messages, 1 untranslated message.
po/sr-RS/mail/chrome/messenger/am-main.dtd.po:	13 translated messages, 4 untranslated messages.
po/sr-RS/mail/chrome/messenger/am-dsn.dtd.po:	0 translated messages, 9 untranslated messages.
po/sr-RS/mail/chrome/messenger/addressbook/abNewCardDialog.dtd.po:	0 translated messages, 1 untranslated message.
po/sr-RS/mail/chrome/messenger/addressbook/abMailListDialog.dtd.po:	9 translated messages.
po/sr-RS/mail/chrome/messenger/addressbook/abDirTreeOverlay.dtd.po:	1 translated message.
po/sr-RS/mail/chrome/messenger/addressbook/pref-directory-add.dtd.po:	21 translated messages.
po/sr-RS/mail/chrome/messenger/addressbook/abResultsPaneOverlay.dtd.po:	19 translated messages, 2 untranslated messages.
po/sr-RS/mail/chrome/messenger/addressbook/abSelectAddressesDialog.dtd.po:	13 translated messages, 2 untranslated messages.
po/sr-RS/mail/chrome/messenger/addressbook/abAddressBookNameDialog.dtd.po:	0 translated messages, 1 untranslated message.
po/sr-RS/mail/chrome/messenger/addressbook/abCardViewOverlay.dtd.po:	9 translated messages.
po/sr-RS/mail/chrome/messenger/addressbook/replicationProgress.properties.po:	6 translated messages, 4 untranslated messages.
po/sr-RS/mail/chrome/messenger/addressbook/addressBook.properties.po:	87 translated messages, 1 untranslated message.
po/sr-RS/mail/chrome/messenger/addressbook/abCardOverlay.dtd.po:	27 translated messages, 27 untranslated messages.
po/sr-RS/mail/chrome/messenger/addressbook/ldapAutoCompErrs.properties.po:	15 translated messages, 1 untranslated message.
po/sr-RS/mail/chrome/messenger/addressbook/pref-directory.dtd.po:	7 translated messages, 1 untranslated message.
po/sr-RS/mail/chrome/messenger/addressbook/abMainWindow.dtd.po:	117 translated messages, 1 untranslated message.
po/sr-RS/mail/chrome/messenger/addressbook/abContactsPanel.dtd.po:	4 translated messages, 5 untranslated messages.
po/sr-RS/mail/chrome/messenger/textImportMsgs.properties.po:	7 translated messages.
po/sr-RS/mail/chrome/messenger/mailViewList.dtd.po:	2 translated messages.
po/sr-RS/mail/chrome/messenger/messenger.properties.po:	192 translated messages, 3 untranslated messages.
po/sr-RS/mail/chrome/messenger/am-mdn.properties.po:	1 translated message.
po/sr-RS/mail/chrome/messenger/mailOverlay.dtd.po:	1 translated message, 3 untranslated messages.
po/sr-RS/mail/chrome/messenger/CustomHeaders.dtd.po:	4 translated messages.
po/sr-RS/mail/chrome/messenger/shutdownWindow.properties.po:	0 translated messages, 2 untranslated messages.
po/sr-RS/mail/chrome/messenger/msgAccountCentral.dtd.po:	16 translated messages.
po/sr-RS/mail/chrome/messenger/am-smime.properties.po:	15 translated messages.
po/sr-RS/mail/chrome/messenger/junkMailInfo.dtd.po:	7 translated messages.
po/sr-RS/mail/chrome/messenger/am-identities-list.dtd.po:	3 translated messages, 2 untranslated messages.
po/sr-RS/mail/chrome/messenger/renameFolderDialog.dtd.po:	2 translated messages.
po/sr-RS/mail/chrome/messenger/FilterListDialog.dtd.po:	16 translated messages, 2 untranslated messages.
po/sr-RS/mail/chrome/messenger/shellservice.properties.po:	4 translated messages.
po/sr-RS/mail/chrome/messenger-newsblog/feed-subscriptions.dtd.po:	10 translated messages.
po/sr-RS/mail/chrome/messenger-newsblog/am-newsblog.dtd.po:	8 translated messages, 1 untranslated message.
po/sr-RS/mail/chrome/messenger-newsblog/feed-properties.dtd.po:	7 translated messages.
po/sr-RS/mail/chrome/messenger-newsblog/newsblog.dtd.po:	0 translated messages, 1 untranslated message.
po/sr-RS/mail/chrome/messenger-newsblog/newsblog.properties.po:	17 translated messages, 2 untranslated messages.
po/sr-RS/mail/chrome/messenger-newsblog/am-newsblog.properties.po:	1 translated message.
po/sr-RS/mail/chrome/messenger-region/region.properties.po:	2 translated messages, 1 untranslated message.
po/sr-RS/mail/chrome/mozapps/downloads/pref-downloads.dtd.po:	18 translated messages.
po/sr-RS/mail/installer/installer.inc.po:	56 translated messages, 7 fuzzy translations, 1 untranslated message.
po/sr-RS/mail/installer/mui.properties.po:	43 translated messages.
po/sr-RS/mail/installer/override.properties.po:	61 translated messages.
po/sr-RS/mail/installer/custom.properties.po:	29 translated messages, 20 untranslated messages.
po/sr-RS/mail/defines.inc.po:	1 translated message, 1 untranslated message.
po/sr-RS/editor/ui/chrome/region/region.properties.po:	0 translated messages, 1 untranslated message.
po/sr-RS/editor/ui/chrome/composer/pref-editing.dtd.po:	14 translated messages, 1 untranslated message.
po/sr-RS/editor/ui/chrome/composer/editor.dtd.po:	16 translated messages.
po/sr-RS/editor/ui/chrome/composer/pref-composer.dtd.po:	20 translated messages.
po/sr-RS/editor/ui/chrome/composer/pref-toolbars.dtd.po:	30 translated messages.
po/sr-RS/editor/ui/chrome/composer/editorOverlay.dtd.po:	263 translated messages, 34 untranslated messages.
po/sr-RS/editor/ui/chrome/composer/editorNavigatorOverlay.dtd.po:	2 translated messages.
po/sr-RS/editor/ui/chrome/composer/editor.properties.po:	176 translated messages.
po/sr-RS/editor/ui/chrome/composer/editorSmileyOverlay.dtd.po:	33 translated messages.
po/sr-RS/editor/ui/chrome/composer/editorPrefsOverlay.dtd.po:	5 translated messages.
po/sr-RS/editor/ui/chrome/composer/pref-publish.dtd.po:	8 translated messages.
po/sr-RS/editor/ui/chrome/dialogs/EditorColorProperties.dtd.po:	14 translated messages.
po/sr-RS/editor/ui/chrome/dialogs/EdDialogOverlay.dtd.po:	4 translated messages, 3 untranslated messages.
po/sr-RS/editor/ui/chrome/dialogs/EdLinkChecker.dtd.po:	7 translated messages.
po/sr-RS/editor/ui/chrome/dialogs/EditorFormProperties.dtd.po:	8 translated messages.
po/sr-RS/editor/ui/chrome/dialogs/EditorButtonProperties.dtd.po:	12 translated messages.
po/sr-RS/editor/ui/chrome/dialogs/EditorImageMapHotSpot.dtd.po:	12 translated messages, 1 untranslated message.
po/sr-RS/editor/ui/chrome/dialogs/EditorFieldSetProperties.dtd.po:	9 translated messages.
po/sr-RS/editor/ui/chrome/dialogs/EditorInsertTable.dtd.po:	8 translated messages.
po/sr-RS/editor/ui/chrome/dialogs/EdConvertToTable.dtd.po:	9 translated messages.
po/sr-RS/editor/ui/chrome/dialogs/EditorTextAreaProperties.dtd.po:	17 translated messages.
po/sr-RS/editor/ui/chrome/dialogs/EditorPublish.dtd.po:	23 translated messages, 17 untranslated messages.
po/sr-RS/editor/ui/chrome/dialogs/EditorPublishProgress.dtd.po:	10 translated messages, 1 untranslated message.
po/sr-RS/editor/ui/chrome/dialogs/EditorInsertTOC.dtd.po:	13 translated messages.
po/sr-RS/editor/ui/chrome/dialogs/EditorHLineProperties.dtd.po:	9 translated messages, 3 untranslated messages.
po/sr-RS/editor/ui/chrome/dialogs/EditorLinkProperties.dtd.po:	2 translated messages.
po/sr-RS/editor/ui/chrome/dialogs/EditorSpellCheck.dtd.po:	16 translated messages, 2 untranslated messages.
po/sr-RS/editor/ui/chrome/dialogs/EdAdvancedEdit.dtd.po:	13 translated messages.
po/sr-RS/editor/ui/chrome/dialogs/EdColorPicker.dtd.po:	12 translated messages.
po/sr-RS/editor/ui/chrome/dialogs/EditorInputProperties.dtd.po:	29 translated messages, 1 untranslated message.
po/sr-RS/editor/ui/chrome/dialogs/EditorTableProperties.dtd.po:	57 translated messages, 1 untranslated message.
po/sr-RS/editor/ui/chrome/dialogs/EditorInsertSource.dtd.po:	5 translated messages.
po/sr-RS/editor/ui/chrome/dialogs/EditorPageProperties.dtd.po:	1 translated message, 8 untranslated messages.
po/sr-RS/editor/ui/chrome/dialogs/EditorImageMap.dtd.po:	40 translated messages.
po/sr-RS/editor/ui/chrome/dialogs/EdNamedAnchorProperties.dtd.po:	2 translated messages, 1 fuzzy translation.
po/sr-RS/editor/ui/chrome/dialogs/EditorPersonalDictionary.dtd.po:	7 translated messages.
po/sr-RS/editor/ui/chrome/dialogs/EditConflict.dtd.po:	5 translated messages.
po/sr-RS/editor/ui/chrome/dialogs/EditorSelectProperties.dtd.po:	21 translated messages.
po/sr-RS/editor/ui/chrome/dialogs/EditorImageProperties.dtd.po:	45 translated messages, 1 untranslated message.
po/sr-RS/editor/ui/chrome/dialogs/EditorInsertChars.dtd.po:	11 translated messages.
po/sr-RS/editor/ui/chrome/dialogs/EditorLabelProperties.dtd.po:	6 translated messages.
po/sr-RS/editor/ui/chrome/dialogs/EditorReplace.dtd.po:	11 translated messages, 1 untranslated message.
po/sr-RS/editor/ui/chrome/dialogs/EditorSaveAsCharset.dtd.po:	5 translated messages.
po/sr-RS/editor/ui/chrome/dialogs/EditorListProperties.dtd.po:	11 translated messages.
po/sr-RS/editor/ui/chrome/dialogs/EditorSnapToGrid.dtd.po:	4 translated messages.
po/sr-RS/browser/updater/updater.ini.po:	2 translated messages.
po/sr-RS/browser/crashreporter/crashreporter-override.ini.po:	2 translated messages.
po/sr-RS/browser/chrome/branding/brand.dtd.po:	po/sr-RS/browser/chrome/branding/brand.dtd.po:22: dubbele melding definitie...
po/sr-RS/browser/chrome/branding/brand.dtd.po:19: ...this is the location of the first definition
msgfmt: found 1 fatal error
po/sr-RS/browser/chrome/branding/brand.properties.po:	po/sr-RS/browser/chrome/branding/brand.properties.po:22: dubbele melding definitie...
po/sr-RS/browser/chrome/branding/brand.properties.po:19: ...this is the location of the first definition
msgfmt: found 1 fatal error
po/sr-RS/browser/chrome/browser-region/region.properties.po:	10 translated messages.
po/sr-RS/browser/chrome/help/platformStrings.dtd.po:	12 translated messages.
po/sr-RS/browser/chrome/browser/engineManager.dtd.po:	12 translated messages.
po/sr-RS/browser/chrome/browser/searchbar.dtd.po:	2 translated messages.
po/sr-RS/browser/chrome/browser/setDesktopBackground.dtd.po:	9 translated messages.
po/sr-RS/browser/chrome/browser/openLocation.dtd.po:	8 translated messages.
po/sr-RS/browser/chrome/browser/cookieviewer/CookieExceptions.dtd.po:	10 translated messages.
po/sr-RS/browser/chrome/browser/cookieviewer/CookieViewer.dtd.po:	14 translated messages.
po/sr-RS/browser/chrome/browser/cookieviewer/CookieViewer.properties.po:	5 translated messages.
po/sr-RS/browser/chrome/browser/aboutRobots.dtd.po:	10 translated messages.
po/sr-RS/browser/chrome/browser/search.properties.po:	12 translated messages.
po/sr-RS/browser/chrome/browser/aboutDialog.dtd.po:	po/sr-RS/browser/chrome/browser/aboutDialog.dtd.po:45: `msgid' en `msgstr' ingangen eindigen niet allebei met '
'
msgfmt: found 1 fatal error
7 translated messages.
po/sr-RS/browser/chrome/browser/openLocation.properties.po:	1 translated message.
po/sr-RS/browser/chrome/browser/tabbrowser.dtd.po:	10 translated messages.
po/sr-RS/browser/chrome/browser/browser.dtd.po:	182 translated messages.
po/sr-RS/browser/chrome/browser/history/history.dtd.po:	14 translated messages.
po/sr-RS/browser/chrome/browser/sanitize.dtd.po:	9 translated messages.
po/sr-RS/browser/chrome/browser/bookmarks/bookmarks.properties.po:	103 translated messages.
po/sr-RS/browser/chrome/browser/bookmarks/addBookmark.dtd.po:	18 translated messages.
po/sr-RS/browser/chrome/browser/bookmarks/bookmarksProperties.dtd.po:	9 translated messages.
po/sr-RS/browser/chrome/browser/bookmarks/bookmarks.dtd.po:	41 translated messages.
po/sr-RS/browser/chrome/browser/migration/migration.dtd.po:	28 translated messages.
po/sr-RS/browser/chrome/browser/migration/migration.properties.po:	30 translated messages.
po/sr-RS/browser/chrome/browser/credits.dtd.po:	po/sr-RS/browser/chrome/browser/credits.dtd.po:41: `msgid' en `msgstr' ingangen eindigen niet allebei met '
'
msgfmt: found 1 fatal error
7 translated messages.
po/sr-RS/browser/chrome/browser/page-drawer.dtd.po:	2 translated messages.
po/sr-RS/browser/chrome/browser/metaData.dtd.po:	25 translated messages.
po/sr-RS/browser/chrome/browser/sidebar/sidebar.properties.po:	2 translated messages.
po/sr-RS/browser/chrome/browser/pageReport.dtd.po:	4 translated messages.
po/sr-RS/browser/chrome/browser/feeds/subscribe.dtd.po:	3 translated messages.
po/sr-RS/browser/chrome/browser/feeds/addFeedReader.dtd.po:	4 translated messages.
po/sr-RS/browser/chrome/browser/feeds/subscribe.properties.po:	31 translated messages.
po/sr-RS/browser/chrome/browser/pageInfo.dtd.po:	69 translated messages.
po/sr-RS/browser/chrome/browser/preferences/content.dtd.po:	15 translated messages.
po/sr-RS/browser/chrome/browser/preferences/preferences.dtd.po:	12 translated messages.
po/sr-RS/browser/chrome/browser/preferences/preferences.properties.po:	66 translated messages.
po/sr-RS/browser/chrome/browser/preferences/tabs.dtd.po:	7 translated messages.
po/sr-RS/browser/chrome/browser/preferences/changeaction.dtd.po:	12 translated messages.
po/sr-RS/browser/chrome/browser/preferences/downloadactions.dtd.po:	16 translated messages.
po/sr-RS/browser/chrome/browser/preferences/fallbackEULA.dtd.po:	1 translated message.
po/sr-RS/browser/chrome/browser/preferences/applications.dtd.po:	6 translated messages.
po/sr-RS/browser/chrome/browser/preferences/sanitize.dtd.po:	9 translated messages.
po/sr-RS/browser/chrome/browser/preferences/colors.dtd.po:	12 translated messages.
po/sr-RS/browser/chrome/browser/preferences/advanced.dtd.po:	43 translated messages.
po/sr-RS/browser/chrome/browser/preferences/phishEULA.dtd.po:	7 translated messages.
po/sr-RS/browser/chrome/browser/preferences/advanced-scripts.dtd.po:	9 translated messages.
po/sr-RS/browser/chrome/browser/preferences/feeds.dtd.po:	5 translated messages.
po/sr-RS/browser/chrome/browser/preferences/languages.dtd.po:	9 translated messages.
po/sr-RS/browser/chrome/browser/preferences/security.dtd.po:	13 translated messages.
po/sr-RS/browser/chrome/browser/preferences/securityWarnings.dtd.po:	7 translated messages.
po/sr-RS/browser/chrome/browser/preferences/cookies.dtd.po:	19 translated messages.
po/sr-RS/browser/chrome/browser/preferences/feeds.properties.po:	1 translated message.
po/sr-RS/browser/chrome/browser/preferences/connection.dtd.po:	25 translated messages, 1 untranslated message.
po/sr-RS/browser/chrome/browser/preferences/selectBookmark.dtd.po:	2 translated messages.
po/sr-RS/browser/chrome/browser/preferences/fonts.dtd.po:	46 translated messages.
po/sr-RS/browser/chrome/browser/preferences/applicationManager.properties.po:	6 translated messages.
po/sr-RS/browser/chrome/browser/preferences/applicationManager.dtd.po:	3 translated messages.
po/sr-RS/browser/chrome/browser/preferences/permissions.dtd.po:	12 translated messages.
po/sr-RS/browser/chrome/browser/preferences/privacy.dtd.po:	20 translated messages.
po/sr-RS/browser/chrome/browser/preferences/main.dtd.po:	21 translated messages.
po/sr-RS/browser/chrome/browser/baseMenuOverlay.dtd.po:	25 translated messages.
po/sr-RS/browser/chrome/browser/browser.properties.po:	84 translated messages.
po/sr-RS/browser/chrome/browser/sessionstore.properties.po:	4 translated messages.
po/sr-RS/browser/chrome/browser/engineManager.properties.po:	5 translated messages.
po/sr-RS/browser/chrome/browser/places/bookmarkProperties.properties.po:	12 translated messages.
po/sr-RS/browser/chrome/browser/places/bookmarkProperties.dtd.po:	12 translated messages.
po/sr-RS/browser/chrome/browser/places/moveBookmarks.dtd.po:	4 translated messages.
po/sr-RS/browser/chrome/browser/places/places.dtd.po:	0 translated messages, 125 untranslated messages.
po/sr-RS/browser/chrome/browser/places/places.properties.po:	0 translated messages, 74 untranslated messages.
po/sr-RS/browser/chrome/browser/places/editBookmarkOverlay.dtd.po:	0 translated messages, 15 untranslated messages.
po/sr-RS/browser/chrome/browser/tabbrowser.properties.po:	10 translated messages.
po/sr-RS/browser/chrome/browser/metaData.properties.po:	16 translated messages.
po/sr-RS/browser/chrome/browser/pageInfo.properties.po:	38 translated messages.
po/sr-RS/browser/chrome/browser/safeMode.dtd.po:	11 translated messages.
po/sr-RS/browser/chrome/browser/safebrowsing/phishing-afterload-warning-message.dtd.po:	20 translated messages.
po/sr-RS/browser/chrome/browser/safebrowsing/blockedSite.properties.po:	6 translated messages.
po/sr-RS/browser/chrome/browser/safebrowsing/report-phishing.dtd.po:	2 translated messages.
po/sr-RS/browser/chrome/browser/quitDialog.properties.po:	10 translated messages.
po/sr-RS/browser/chrome/browser/pageReportFirstTime.dtd.po:	4 translated messages.
po/sr-RS/browser/chrome/browser/shellservice.properties.po:	9 translated messages.
po/sr-RS/browser/chrome/overrides/netError.dtd.po:	43 translated messages, 1 untranslated message.
po/sr-RS/browser/chrome/overrides/settingsChange.dtd.po:	2 translated messages.
po/sr-RS/browser/chrome/overrides/appstrings.properties.po:	26 translated messages.
po/sr-RS/browser/installer/installer.inc.po:	144 translated messages.
po/sr-RS/browser/installer/mui.properties.po:	43 translated messages.
po/sr-RS/browser/installer/override.properties.po:	61 translated messages.
po/sr-RS/browser/installer/custom.properties.po:	57 translated messages.
po/sr-RS/browser/defines.inc.po:	2 translated messages.
po/sr-RS/other-licenses/branding/firefox/brand.dtd.po:	3 translated messages.
po/sr-RS/other-licenses/branding/firefox/brand.properties.po:	7 translated messages.
po/sr-RS/other-licenses/branding/thunderbird/brand.dtd.po:	3 translated messages.
po/sr-RS/other-licenses/branding/thunderbird/brand.properties.po:	3 translated messages.
po/sr-RS/extensions/reporter/chrome/reporterOverlay.dtd.po:	3 translated messages.
po/sr-RS/extensions/reporter/chrome/reportResults.dtd.po:	15 translated messages.
po/sr-RS/extensions/reporter/chrome/reportWizard.properties.po:	9 translated messages.
po/sr-RS/extensions/reporter/chrome/reportWizard.dtd.po:	31 translated messages.
po/sr-RS/extensions/reporter/chrome/about.dtd.po:	3 translated messages.
po/sr-RS/extensions/reporter/chrome/reporter.dtd.po:	2 translated messages.
po/sr-RS/extensions/irc/chrome/channels.dtd.po:	0 translated messages, 11 untranslated messages.
po/sr-RS/extensions/irc/chrome/chatzilla.properties.po:	0 translated messages, 1166 untranslated messages.
po/sr-RS/extensions/irc/chrome/config.dtd.po:	0 translated messages, 21 untranslated messages.
po/sr-RS/extensions/irc/chrome/chatzillaOverlay.dtd.po:	0 translated messages, 2 untranslated messages.
po/sr-RS/extensions/irc/chrome/pref-irc.dtd.po:	0 translated messages, 5 untranslated messages.
po/sr-RS/extensions/irc/chrome/chatzilla.dtd.po:	0 translated messages, 12 untranslated messages.
po/sr-RS/extensions/irc/chrome/browserOverlay.dtd.po:	0 translated messages, 2 untranslated messages.
po/sr-RS/extensions/irc/defines.inc.po:	0 translated messages, 1 fuzzy translation, 2 untranslated messages.
po/sr-RS/extensions/metrics/prefs.dtd.po:	4 translated messages.
po/sr-RS/extensions/cck/browser/chrome/cckwizard.properties.po:	0 translated messages, 21 untranslated messages.
po/sr-RS/extensions/cck/browser/chrome/cckWizard.dtd.po:	0 translated messages, 165 untranslated messages.
po/sr-RS/extensions/wallet/resources/walletNavigatorOverlay.dtd.po:	12 translated messages.
po/sr-RS/extensions/wallet/resources/walletPrefsOverlay.dtd.po:	2 translated messages.
po/sr-RS/extensions/wallet/resources/walletTasksOverlay.dtd.po:	15 translated messages.
po/sr-RS/extensions/wallet/resources/pref-wallet.dtd.po:	6 translated messages.
po/sr-RS/extensions/wallet/resources/pref-passwords.dtd.po:	8 translated messages.
po/sr-RS/extensions/cview/resources/cviewOverlay.dtd.po:	1 translated message.
po/sr-RS/extensions/venkman/chrome/venkman-overlay.dtd.po:	3 translated messages.
po/sr-RS/extensions/venkman/chrome/venkman.dtd.po:	0 translated messages, 46 untranslated messages.
po/sr-RS/extensions/venkman/chrome/venkman.properties.po:	0 translated messages, 596 untranslated messages.
po/sr-RS/extensions/venkman/defines.inc.po:	po/sr-RS/extensions/venkman/defines.inc.po:49: `msgid' en `msgstr' ingangen eindigen niet allebei met '
'
msgfmt: found 1 fatal error
3 translated messages.
po/sr-RS/extensions/signonviewer/resources/SignonViewer.properties.po:	7 translated messages.
po/sr-RS/extensions/signonviewer/resources/SignonViewer.dtd.po:	16 translated messages.
po/sr-RS/dom/chrome/accessibility/unix/accessible.properties.po:	13 translated messages.
po/sr-RS/dom/chrome/accessibility/win/accessible.properties.po:	13 translated messages.
po/sr-RS/dom/chrome/accessibility/mac/accessible.properties.po:	13 translated messages.
po/sr-RS/dom/chrome/netErrorApp.dtd.po:	2 translated messages.
po/sr-RS/dom/chrome/prompts.properties.po:	4 translated messages.
po/sr-RS/dom/chrome/security/caps.properties.po:	21 translated messages.
po/sr-RS/dom/chrome/xml/prettyprint.dtd.po:	1 translated message.
po/sr-RS/dom/chrome/netError.dtd.po:	43 translated messages.
po/sr-RS/dom/chrome/webservices/security.properties.po:	8 translated messages.
po/sr-RS/dom/chrome/charsetTitles.properties.po:	99 translated messages.
po/sr-RS/dom/chrome/printdialog.properties.po:	5 translated messages.
po/sr-RS/dom/chrome/dom/dom.properties.po:	22 translated messages.
po/sr-RS/dom/chrome/global.dtd.po:	1 translated message.
po/sr-RS/dom/chrome/xslt/xslt.properties.po:	32 translated messages, 1 untranslated message.
po/sr-RS/dom/chrome/storage.properties.po:	1 translated message.
po/sr-RS/dom/chrome/global-strres.properties.po:	1 translated message.
po/sr-RS/dom/chrome/plugins.properties.po:	12 translated messages.
po/sr-RS/dom/chrome/layout/layout_errors.properties.po:	5 translated messages.
po/sr-RS/dom/chrome/layout/xul.properties.po:	4 translated messages.
po/sr-RS/dom/chrome/layout/xmlparser.properties.po:	26 translated messages, 9 untranslated messages.
po/sr-RS/dom/chrome/layout/css.properties.po:	86 translated messages, 6 untranslated messages.
po/sr-RS/dom/chrome/layout/HtmlForm.properties.po:	7 translated messages, 1 untranslated message.
po/sr-RS/dom/chrome/layout/MediaDocument.properties.po:	9 translated messages.
po/sr-RS/dom/chrome/layout/xbl.properties.po:	1 translated message, 5 untranslated messages.
po/sr-RS/dom/chrome/layout/printing.properties.po:	47 translated messages.
po/sr-RS/dom/chrome/nsWebBrowserPersist.properties.po:	11 translated messages.
po/sr-RS/dom/chrome/svg/svg.properties.po:	0 translated messages, 1 untranslated message.
po/sr-RS/dom/chrome/appstrings.properties.po:	20 translated messages, 6 untranslated messages.
po/sr-RS/netwerk/necko.properties.po:	25 translated messages.
po/sr-RS/netwerk/necko/necko.properties.po:	11 translated messages, 14 untranslated messages.
po/sr-RS/toolkit/crashreporter/crashes.properties.po:	0 translated messages, 2 untranslated messages.
po/sr-RS/toolkit/crashreporter/crashreporter.ini.po:	0 translated messages, 37 untranslated messages.
po/sr-RS/toolkit/crashreporter/crashes.dtd.po:	0 translated messages, 6 untranslated messages.
po/sr-RS/toolkit/chrome/alerts/notificationNames.properties.po:	1 translated message.
po/sr-RS/toolkit/chrome/autoconfig/autoconfig.properties.po:	6 translated messages.
po/sr-RS/toolkit/chrome/global-platform/unix/platformKeys.properties.po:	5 translated messages.
po/sr-RS/toolkit/chrome/global-platform/unix/intl.properties.po:	1 translated message, 1 untranslated message.
po/sr-RS/toolkit/chrome/global-platform/win/platformKeys.properties.po:	5 translated messages.
po/sr-RS/toolkit/chrome/global-platform/win/intl.properties.po:	1 translated message, 1 untranslated message.
po/sr-RS/toolkit/chrome/global-platform/mac/platformKeys.properties.po:	4 translated messages, 1 untranslated message.
po/sr-RS/toolkit/chrome/global-platform/mac/intl.properties.po:	1 translated message, 1 untranslated message.
po/sr-RS/toolkit/chrome/global/nsProgressDialog.properties.po:	4 translated messages.
po/sr-RS/toolkit/chrome/global/dialogOverlay.dtd.po:	3 translated messages.
po/sr-RS/toolkit/chrome/global/preferences.dtd.po:	4 translated messages.
po/sr-RS/toolkit/chrome/global/wizard.dtd.po:	9 translated messages.
po/sr-RS/toolkit/chrome/global/finddialog.properties.po:	2 translated messages.
po/sr-RS/toolkit/chrome/global/finddialog.dtd.po:	10 translated messages.
po/sr-RS/toolkit/chrome/global/findbar.dtd.po:	8 translated messages.
po/sr-RS/toolkit/chrome/global/license.dtd.po:	5 translated messages.
po/sr-RS/toolkit/chrome/global/dialog.properties.po:	4 translated messages, 4 untranslated messages.
po/sr-RS/toolkit/chrome/global/tabbrowser.dtd.po:	8 translated messages.
po/sr-RS/toolkit/chrome/global/appPicker.dtd.po:	0 translated messages, 3 untranslated messages.
po/sr-RS/toolkit/chrome/global/filepicker.dtd.po:	11 translated messages.
po/sr-RS/toolkit/chrome/global/history/history.properties.po:	10 translated messages.
po/sr-RS/toolkit/chrome/global/commonDialogs.properties.po:	15 translated messages.
po/sr-RS/toolkit/chrome/global/datetimepicker.dtd.po:	0 translated messages, 1 untranslated message.
po/sr-RS/toolkit/chrome/global/keys.properties.po:	24 translated messages, 11 untranslated messages.
po/sr-RS/toolkit/chrome/global/accept2locale.properties.po:	10 translated messages.
po/sr-RS/toolkit/chrome/global/contentAreaCommands.properties.po:	8 translated messages, 1 untranslated message.
po/sr-RS/toolkit/chrome/global/wizard.properties.po:	4 translated messages.
po/sr-RS/toolkit/chrome/global/config.dtd.po:	16 translated messages, 8 untranslated messages.
po/sr-RS/toolkit/chrome/global/editMenuOverlay.dtd.po:	20 translated messages.
po/sr-RS/toolkit/chrome/global/viewSource.dtd.po:	25 translated messages, 5 untranslated messages.
po/sr-RS/toolkit/chrome/global/console.properties.po:	6 translated messages.
po/sr-RS/toolkit/chrome/global/config.properties.po:	9 translated messages.
po/sr-RS/toolkit/chrome/global/charsetOverlay.dtd.po:	9 translated messages, 1 untranslated message.
po/sr-RS/toolkit/chrome/global/printjoboptions.dtd.po:	17 translated messages.
po/sr-RS/toolkit/chrome/global/customizeToolbar.properties.po:	7 translated messages.
po/sr-RS/toolkit/chrome/global/notification.dtd.po:	0 translated messages, 1 untranslated message.
po/sr-RS/toolkit/chrome/global/customizeToolbar.dtd.po:	11 translated messages, 1 untranslated message.
po/sr-RS/toolkit/chrome/global/findbar.properties.po:	6 translated messages, 4 untranslated messages.
po/sr-RS/toolkit/chrome/global/console.dtd.po:	16 translated messages, 2 untranslated messages.
po/sr-RS/toolkit/chrome/global/printProgress.dtd.po:	7 translated messages, 1 untranslated message.
po/sr-RS/toolkit/chrome/global/printdialog.dtd.po:	18 translated messages, 1 untranslated message.
po/sr-RS/toolkit/chrome/global/tree.dtd.po:	0 translated messages, 1 untranslated message.
po/sr-RS/toolkit/chrome/global/intl.properties.po:	13 translated messages, 3 untranslated messages.
po/sr-RS/toolkit/chrome/global/printPageSetup.dtd.po:	34 translated messages, 1 untranslated message.
po/sr-RS/toolkit/chrome/global/gnomeprintdialog.properties.po:	0 translated messages, 23 untranslated messages.
po/sr-RS/toolkit/chrome/global/nsTreeSorting.properties.po:	1 translated message.
po/sr-RS/toolkit/chrome/global/browser.properties.po:	0 translated messages, 4 untranslated messages.
po/sr-RS/toolkit/chrome/global/downloadProgress.properties.po:	3 translated messages.
po/sr-RS/toolkit/chrome/global/nsHelperAppDlg.dtd.po:	16 translated messages, 1 untranslated message.
po/sr-RS/toolkit/chrome/global/regionNames.properties.po:	72 translated messages, 171 untranslated messages.
po/sr-RS/toolkit/chrome/global/printPreview.dtd.po:	23 translated messages, 4 untranslated messages.
po/sr-RS/toolkit/chrome/global/printPreviewProgress.dtd.po:	3 translated messages, 1 untranslated message.
po/sr-RS/toolkit/chrome/global/commonDialog.dtd.po:	6 translated messages, 2 untranslated messages.
po/sr-RS/toolkit/chrome/global/viewSource.properties.po:	9 translated messages.
po/sr-RS/toolkit/chrome/global/tabbrowser.properties.po:	14 translated messages.
po/sr-RS/toolkit/chrome/global/mozilla.dtd.po:	0 translated messages, 2 untranslated messages.
po/sr-RS/toolkit/chrome/global/filepicker.properties.po:	38 translated messages, 2 untranslated messages.
po/sr-RS/toolkit/chrome/global/customizeCharset.dtd.po:	7 translated messages.
po/sr-RS/toolkit/chrome/global/about.dtd.po:	0 translated messages, 13 untranslated messages.
po/sr-RS/toolkit/chrome/global/nsHelperAppDlg.properties.po:	1 translated message, 1 untranslated message.
po/sr-RS/toolkit/chrome/global/languageNames.properties.po:	185 translated messages, 8 untranslated messages.
po/sr-RS/toolkit/chrome/global/xpinstall/xpinstall.properties.po:	64 translated messages.
po/sr-RS/toolkit/chrome/global/nsProgressDialog.dtd.po:	27 translated messages.
po/sr-RS/toolkit/chrome/global/textcontext.dtd.po:	7 translated messages, 3 untranslated messages.
po/sr-RS/toolkit/chrome/global-region/region.properties.po:	5 translated messages.
po/sr-RS/toolkit/chrome/global-region/region.dtd.po:	1 translated message.
po/sr-RS/toolkit/chrome/passwordmgr/passwordManager.dtd.po:	14 translated messages.
po/sr-RS/toolkit/chrome/passwordmgr/passwordmgr.properties.po:	29 translated messages.
po/sr-RS/toolkit/chrome/places/places.properties.po:	0 translated messages, 15 untranslated messages.
po/sr-RS/toolkit/chrome/cookie/cookieAcceptDialog.properties.po:	14 translated messages.
po/sr-RS/toolkit/chrome/cookie/cookieAcceptDialog.dtd.po:	12 translated messages.
po/sr-RS/toolkit/chrome/mozapps/downloads/downloads.dtd.po:	29 translated messages.
po/sr-RS/toolkit/chrome/mozapps/downloads/unknownContentType.dtd.po:	7 translated messages, 4 untranslated messages.
po/sr-RS/toolkit/chrome/mozapps/downloads/unknownContentType.properties.po:	8 translated messages, 12 untranslated messages.
po/sr-RS/toolkit/chrome/mozapps/downloads/downloads.properties.po:	41 translated messages.
po/sr-RS/toolkit/chrome/mozapps/downloads/settingsChange.dtd.po:	0 translated messages, 2 untranslated messages.
po/sr-RS/toolkit/chrome/mozapps/downloads/downloadProperties.dtd.po:	7 translated messages.
po/sr-RS/toolkit/chrome/mozapps/handling/handling.dtd.po:	3 translated messages.
po/sr-RS/toolkit/chrome/mozapps/handling/handling.properties.po:	0 translated messages, 7 untranslated messages.
po/sr-RS/toolkit/chrome/mozapps/update/history.dtd.po:	8 translated messages.
po/sr-RS/toolkit/chrome/mozapps/update/updates.properties.po:	78 translated messages.
po/sr-RS/toolkit/chrome/mozapps/update/incompatible.dtd.po:	5 translated messages.
po/sr-RS/toolkit/chrome/mozapps/update/errors.dtd.po:	1 translated message.
po/sr-RS/toolkit/chrome/mozapps/update/updates.dtd.po:	47 translated messages.
po/sr-RS/toolkit/chrome/mozapps/help/welcome.xhtml.po:	0 translated messages, 13 untranslated messages.
po/sr-RS/toolkit/chrome/mozapps/help/help.properties.po:	1 translated message.
po/sr-RS/toolkit/chrome/mozapps/help/help.dtd.po:	25 translated messages, 3 untranslated messages.
po/sr-RS/toolkit/chrome/mozapps/extensions/extensions.properties.po:	93 translated messages.
po/sr-RS/toolkit/chrome/mozapps/extensions/extensions.dtd.po:	116 translated messages.
po/sr-RS/toolkit/chrome/mozapps/extensions/update.properties.po:	16 translated messages.
po/sr-RS/toolkit/chrome/mozapps/extensions/update.dtd.po:	34 translated messages.
po/sr-RS/toolkit/chrome/mozapps/extensions/about.dtd.po:	5 translated messages.
po/sr-RS/toolkit/chrome/mozapps/preferences/ocsp.dtd.po:	2 translated messages, 5 untranslated messages.
po/sr-RS/toolkit/chrome/mozapps/preferences/preferences.properties.po:	12 translated messages.
po/sr-RS/toolkit/chrome/mozapps/preferences/changemp.dtd.po:	9 translated messages.
po/sr-RS/toolkit/chrome/mozapps/preferences/removemp.dtd.po:	5 translated messages.
po/sr-RS/toolkit/chrome/mozapps/plugins/plugins.dtd.po:	13 translated messages, 3 untranslated messages.
po/sr-RS/toolkit/chrome/mozapps/plugins/plugins.properties.po:	17 translated messages.
po/sr-RS/toolkit/chrome/mozapps/profile/profileSelection.dtd.po:	8 translated messages, 3 untranslated messages.
po/sr-RS/toolkit/chrome/mozapps/profile/createProfileWizard.dtd.po:	11 translated messages, 2 untranslated messages.
po/sr-RS/toolkit/chrome/mozapps/profile/profileSelection.properties.po:	26 translated messages, 1 untranslated message.
po/sr-RS/toolkit/chrome/mozapps/xpinstall/xpinstallConfirm.properties.po:	7 translated messages, 2 untranslated messages.
po/sr-RS/toolkit/chrome/mozapps/xpinstall/xpinstallConfirm.dtd.po:	3 translated messages, 2 untranslated messages.
po/sr-RS/toolkit/installer/unix/install.it.po:	76 translated messages.
po/sr-RS/toolkit/installer/windows/install.it.po:	121 translated messages.
po/sr-RS/toolkit/defines.inc.po:	1 translated message.
